XXXXXXXXXXXXXXXXXXXXXXXXX
X X                 X   X
X X XXXXXXX XXXXXXX X X X
X     X   X X     X   X X
XXXXXXX X X X XXX XXXXX X
X     X X   X X     X   X
X XXX X XXXXX X XXXXX XXX
X   X   X X   X X     X X
XXX XXXXX X XXX X XXXXX X
X   X     X X   X   X   X
X XXX X XXX X X XXX XXX X
X X X X   X X X   X   X X
X X X XXX X X XXXXXXX X X
X X   X X   X   X   X   X
X X XXX XXXXXXX X X XXX X
X X   X       X   X X   X
X XXX X XXXXXXX XXX X XXX
X X X   X     X X   X   X
X X XXX X XXX X X XXXXX X
X X     X   X X X X   X X
X XXXXXXXXX XXXXX X X X X
X X   X   X X     X X   X
X X X X X X X XXXXX XXXXX
X   X   X   X           X
XXXXXXXXXXXXXXXXXXXXXXXXX