XXXXXXXXXXXXXXXXXXXXXXXXX
X   X X X           X   X
X XXX X X X XXXXXXX XXX X
X   X X   X     X     X X
XXX X XXXXXXX X XXXXX X X
X   X X     X X     X   X
X X X X XXX X XXXXX XXX X
X X X   X   X X   X X X X
X XXXXXXX XXX X XXX X X X
X     X   X X X   X X   X
X XXX X XXX X XXX X XXX X
X   X X X         X   X X
XXX X X X XXXXXXXXXXX X X
X   X X X X X     X   X X
XXXXX X X X X XXX X XXX X
X   X X X   X X X   X   X
X X X X XXXXX X XXXXX XXX
X X   X       X     X   X
X XXX XXXXXXXXX X XXXXX X
X X         X   X X   X X
X XXXXXXXXXXX XXX X X X X
X             X   X X   X
X XXXXXXXXXXXXX XXX XXXXX
X             X         X
XXXXXXXXXXXXXXXXXXXXXXXXX

