XXXXXXXXXXXXXXXXXXXXXXXXX
X     X                 X
XXXXX XXX XXXXXXXXXXXXX X
X   X   X   X       X   X
X X XXX XXXXX XXXXX X XXX
X X   X       X   X X   X
X XXX XXXXXXXXX X X X X X
X X X   X       X X X X X
X X XXX X XXXXX XXX XXX X
X   X   X   X X   X   X X
XXXXX X XXX X XXX XXX X X
X   X X   X X   X   X X X
X X X XXXXX X X X XXX X X
X X   X     X X X     X X
X XXXXX XXXXXXX XXXXXXX X
X X   X X     X   X     X
X X X X XXX X X X XXX X X
X   X X X   X   X     X X
X XXX X X XXXXXXXXXXXXX X
X   X   X X   X   X     X
XXX XXXXX X XXX X X XXXXX
X X X     X X   X X   X X
X X X XXXXX X XXX XXX X X
X     X         X       X
XXXXXXXXXXXXXXXXXXXXXXXXX

